1111111111111111111111111111111111
1000000000000000000000000000000001
100000000000000X00CCCCCCCC00000001
1000000000C00000000000000000000001
101001E100100000101001000000010101
1010010010101010001001000000010101
1010010010101010001001000000010101
1010010010101010001001000000010101
1010010010101010001001000000010101
10100100101X1010001001000000010101
1010010010X00000001001000000010101
100000000000000P000000000000000011
1111111111111111111111111111111111
