1111111111111111111111111111111111
1C0000000000000C00000C000000000001
1C0000000000000C00000C000000000001
1C0000000000000C00000C000000000001
101001E100100000101001000000010101
1010010010101010C01001000000010101
1010010010101010C01001000000010101
1010010010101010C01001000000010101
1010010010101010C01001000000010101
1010010010101010C01001000000010101
1010010010XXXX10C01001000000010101
10000000C00C000P000000000000000C11
1111111111111111111111111111111111
