1111111111111111111111111111111111
1000000000000000000000000000000001
1000000000000000000000000000000001
1000000000C00000000000000000000001
101001E100100000101001000000010101
1010010010101010001001000000010101
1010010010101010001001000000010101
1010010010101010001001000000010101
1010010010101010001001000000010101
1010010010101010001001000000010101
1010010010XXXX00001001000000010101
100000000000000P00CCCC0C0000000011
1111111111111111111111111111111111
