1111111111111
1CC1CCCCCCCC1
1CCCCX0001CC1
1PCC11ECCCCC1
1111111111111
